SO file.cub
WE file.cub
EA file.cub
NO file.cub

F 0000,000000000000000000000255,00000154
C 245,12,54



111111111111111111111			111111111
1000000000000001				100000001
10000000000000111111111111111111100000001
10000000000000000000000000000000001111111
10000000000000011111111111111111100000001
1000000000000001				100000001
1000000000000001				111111111
1000000000000001
1000000000000001
1111111111111111