SO file.cub
WE file.cub
EA file.cub
NO file.cub

F 0000,000000000000000000000255,00000154
C 242,212,54


				!
				
1111111111111111
1000000000000001				111111111
10000000000000111111111111111111100000001
10000000000000000000000000000000000001111
10000000000000011111111111111111100000001
1000000 00000001				100000001
1000000000000001111				111111111
1000000000000000001
100000010000000111
1111111 1111111
111111111
11111111



1111111111111111
1000000000000001				111111111
10000000000000111111111111111111100000001
10000000000000000000000000000000000001111
10000000000000011111111111111111100000001
1000000 00000001				100000001
1000000000000001111				111111111
1000000000000000001
100000010000000111
1111111 1111111
111111111
11111111


