SO file.cub
WE file.cub
EA file.cub
as file.cub

F fifth
C sixth



   							1111111111111111
100000     0000000001
100000000000001
10000000000000011111111111111111 
1000000000000001
1000000000000001
1000000000000001
1000000000000001
1111111111111111