SO ./texture/nhl_flipped.xpm
WE ./texture/wild_flipped.xpm
EA ./texture/wild_flipped.xpm
NO ./texture/nhl_flipped.xpm

C 255,255,255
F 105,105,105


111111111111111111111111111111111111
100000000000100000000000010000000001
100000000000100000000000010000000001
100000000000100010000000010000000001
111111111110111111111111010000000001
100000000000000000000000000000000001
100000111111111111110000011111111111
100000111111111111110000011111111111
100000000000000000000000011111111111
10000011111111111111000S011111111111
100000111111111111110000011111111111
100000000000000000000000000000000001
100000000000000000000000000000000001
100000000000000000000000000000000001
100000000000000000000000000000000001
100000000000000000000000000000000001
100000000000000000000000000000000001
100000000000000000000000000000000001
100000000000000000000000000000000001
100000000000000000000000000000000001
100000000000000000000000000000000001
100000000000000000000000000000000001
100000011111111111111111100000000001
100000011111111111111111100000000001
100000011111111111111111111111111111
100000011111111111111111100000000001
100000011111111111111111100000000001
100000011111111111111111100000000001
100000011111111111111111100000000001
100000011111111111111111100000000001
100000000000000000000000000000000001
100000010000000000000000000000000001
100000010001111111110000000000000001
100000010001111111110000000000000001
100000010001111111110000000000000001
100000010001111111110000000000000001
100000010001111111110000000000000001
100000010001111111110000000000000001
100000010001111111110000000000000001
100000010000000000000000000000000001
100000000000000000000000000000000001
100000011111111111111111111111111111
100000000000000000000000000000000001
100000010000000000000000000000000001
100000010000000000000000000000000001
100000010000000000000000000000000001
100000010000000000000000000000000001
100000010000000000000000000000000001
100000010000000000000000000000000001
100000010000000000000000000000000001
100000010000000000000000000000000001
100000010000000000000000000000000001
100000010000000000000000000000000001
100000010000000000000000000000000001
100000000000000000000000000000000001
100000011111111111111111111111111111
100000011111111111111111100000000001
100000011111111111111111100000000001
100000011111111111111111100000000001
100000011111111111111111100000000001
100000000000000000000000000000000001
100000011111111111111100010111111101
100000011111111111111100010000000001
100000011111111111111100010000000001
100000011111111111111100011111111111
100000000000000000000000011111111111
100000000000000000000000011111111111
111011111111111111111111010000000001
100000000000001000000000000000000001
100000000000001000000000000000000001
100000000000001000000000000000000001
100000000000001000000000000000000001
100000000000001000000000000000000001
100000000000001000000000000000000001
100000000000001000000000000000000001
111111111111111111111111111111111111