SO ./maps/valid_map.cub
WE ./maps/valid_map.cub
EA ./maps/valid_map.cub
NO ./maps/valid_map.cub

F 0000,000000000000000000000255,00000154
C 242      ,      212     ,     54

11111111111111111111111111
10000000000000000000000001
10000000000000000000000001
10000000000000000000000001
10000000000000000000000001
10000000000000000000000001
10000000000000000000000001
1000000000000000000000000111111111
100000000000000000000000000000001
100000000000000000000000000000001
1000000000000000000000000111111111 
=========
10000000000000000000000001
10000000000000000000000001
100000000000W0000000000001
10000000000000000000000001
1000000000000000000000000111111111
100000000000000000000000000000001
100000000000000000000000000000001
1000000000000000000000000111111111
10000000000000000000000001
10000000000010000000000001
10000000000000000000000001
11100000000000000000000001
10000000000000000000000001
10000000000000000000000001
10000000000000000000000001
11111111111111111111111111