SO ./maps/valid_map.cub
WE ./maps/valid_map.cub
EA ./maps/valid_map.cub
NO ./maps/valid_map.cub

F 0000,000000000000000000000255,00000154
C 242      ,      212     ,     54

11111111111111111111111111
10000000000000000000000001
10000000000000000000000001
10000000000000000100100001
10000000000000000100100001
10000000011100000100100001
10000000000000000000000001
1000000000000100000000000111111111     1111111
1000000000001110000000000000000011111110000001
100000000000010000000000000000001      1111111
1000001111000000000000000111111111
100000000110000000000000001
10000000000000000000100001
100000100100W 0000 0000001
10000000000000000000000001
1000010000010000000000000111111111
1000010000001111110000000000000001
100001000000000000000000000000001
1000010000000000000000000111111111
10000100000000000000000001
10011100000010000000000001
10010000000000000000000001
11110000000000000000000001
10000000000000000000000001
10000000000000000000000001
10000000000000000000000001
11111111111111111111111111