SO ./maps/valid_map.cub
WE ./maps/test_map.cub

EA ./maps/valid_map.cub
NO ./maps/test_map.cub

F 0000,000000000000000000000255,00000154
C 242      ,      212,        54

1111111111111111111111111
10000000000000000000000001
10000000000000000000000001
10000000000000000100100001
10000000000000000100100001
10000000011100000100100001
100000000000000000000000011111111111  11111111
100001000000010000000000011111111111111 000001
1000001000001110000000000000000011111 0000000111
10000000000010000000000000000001   1111000001
1000001111000000000000000111111111     1111111
1000000001100000W00000000001
100000010000000000001000011
100000100100000000000001111
10000000000000000000000001
100001000010000000000000111111111
100001000001111110000000000000001
100001000000000000000000000000001
1000010000000000000000000111111111
10000100000000000000000001
10011100000010000000000001
10010000000000000000000001
11110000000000000000000001
10000000000000000000000001
10000000000000000000000001
10000000000000000000000001
11111111111111111111111111