SO ./texture/eemuston.xpm
WE ./texture/atoof.xpm
EA ./texture/great_texture.xpm
NO ./texture/subject.xpm

C 111,124,211
F 105,105,105


111111
100001
10N001
100001
111111
