SO ./maps/valid_map.cub
WE ./maps/valid_map.cub
EA ./maps/valid_map.cub
NO ./maps/valid_map.cub

F 0000,000000000000000000000255,00000154
C 242,212,54



      1
1111111111111111
1000000000000001                111111111
10000000000000111111111111111111100000001
10000000000000000000000000000000000001111
100000000000000111111111111111100000001
100000000000001                100000001
1000000000000001111             111111111
1000000000000000001     11111
100000010000000111111111    11111
111111111111111            10001
1111111111111111           11111
1000000000000001               11111111111
1000000000000011111111111111111110000000W1
10000000000000000000000000000000000001111
100000000000000011111111111111111100000001
1000000000000001                100000001
1000000000000001111   11         111111111
1000000000000000001   101
100000010000000111111111111
111111111111111       
11111111