SO ./maps/valid_map.cub
WE ./maps/valid_map.cub
EA ./maps/valid_map.cub
NO ./maps/valid_map.cub

F 0000,000000000000000000000255,00000154
C 242,212,54



1111111111111111
1000000000000001
1000000000000001
1000000000000001        11111111111
100000W0 000000011111111111000000001
1000000000000001        10000000011
1000000000000001        1111111111
1111111111111111
