      		EA ./texture/wall_brick_red.xpm
		  SO 	    ./texture/wall_brick_gray.xpm
	  WE 		  	./texture/wall_brick_black.xpm
NO 			./texture/wall_brick_orange.xpm


C 		  	99, 		49   ,			   231

F 		   192,	236, 42 


1111111111111111
1000000000000001
1000000000000001
1000001100000001        11111111111
100000S0000000011111111111000000001
1000000000000001        10000000011
1000000000000001        1111111111
1111111110011111
1111111101111111
1000000000000001
1000000000000001
1000000000000001        11111111111
1000000000000011111111111000000001
1000000000000001        10000000011
1000000000000001        1111111111
1111111111111111